XXXXXXXXXXXXXXXXXXXX
X                X
X P              X
X XXXX           X
X                X
X       XXXX     X
X                X
X             E  X
XXXXXXXXXXXXXXXXXXXX