XXXXXXXXXXXXXXXXXXXX
X                  X
X                  X
X                  X
X           XXXXX  X
X                  X
XP                 X
XXXXXXXXXXXXXXXXXXXX