XXXXXXXXXXXXXXXXXXXX
X E                X
X XXXX             X
X                  X
X      XXXX        X
X                  X
X P                X
XXXXXXXXXXXXXXXXXXXX